---------------------------------------------------
---------------------------------------------------
---0123210-------------------------------0123210---
-----------01233210-------------01233210-----------
---------------------233--332----------------------
---------------------233--332----------------------
--------------12331-------------13321--------------
-----------12222221-------------12222221-----------
---------1221-------------------------1221---------
-------122321-------------------------123221-------
------2233321-------------------------1233322------
---------------------------------------------------
------2233321-------------------------1233322------
-------122321-------------------------123221-------
---------1221-------------------------1221---------
-----------12222221-------------12222221-----------
--------------12331-------------13321--------------
---------------------233--332----------------------
---------------------233--332----------------------
-----------01233210-------------01233210-----------
---0123210-------------------------------0123210---
---------------------------------------------------
---------------------------------------------------
