-----------------------------------------------4---
-----------------------------------------------4---
-----------------------------------------------4---
------------------------005550001--------------4---
----------------------00---------11----------------
------5--------------1-------------2---------------
------5--------------1--------------2--------------
------5-------------1----------------2-------------
-------5------------2----------------1-------------
-------0------------2-----------------1------------
-------0------------2-------5---------1------------
--------0------------1----05----------0------------
--------1-------------1100------------0------------
---------1----------------------------0------------
----------1---------------------------5------------
-----------2-------------------------5-------------
------------21----------------------0--------------
--------------11------------------00---------------
----------------0005----------2111-----------------
--------------------5500011122---------------------
---------------------------------------------------
---------------------------------------------------
-----------------------------------------------4---
