---------------------------------------------------
---------------------------------------------------
---------------------------------------------------
---------------------------------------------------
---------------------------------------------------
--------5555555555555555---5555555555555555--------
--------0--------------0---0--------------0--------
--------1--------------1---1--------------1--------
--------2--------------2---2--------------2--------
--------1005---------------------------5001--------
---------------------------------------------------
---------------------------------------------------
---------------------------------------------------
--------1005---------------------------5001--------
--------2--------------2---2--------------2--------
--------1--------------1---1--------------1--------
--------0--------------0---0--------------0--------
--------5555555555555555---5555555555555555--------
---------------------------------------------------
---------------------------------------------------
---------------------------------------------------
---------------------------------------------------
---------------------------------------------------
