---------------------------------------------------
---------------------------------------------------
---------------------------------------------------
---------55555555555555555554----------------------
---------33333333333333333343----------------------
---------------------------53----------------------
---------53----------------53----------------------
---------53----------------53----------------------
---------53----------------53----------------------
---------53----------------43----------------------
---------53----------------------------------------
---------54555555555555555555555555555554----------
---------43333333333333333333333333333343----------
---------------------------------------53----------
----------------------43---------------53----------
----------------------53---------------53----------
----------------------53---------------53----------
----------------------53---------------43----------
----------------------53---------------------------
----------------------5455555555555555554----------
----------------------4333333333333333333----------
---------------------------------------------------
---------------------------------------------------
