--------------------------------------5------------
--------------------------------------5------------
------5------------------5------------4------------
------5------------------5------------4------------
--5555455555555----------5------------3---5--------
------5------------------5------------4---5--------
------4-------------5555554443433334344454555555---
------4------------------5----------------5--------
------3-----5------------4----------------4--------
------3-----0------------5----------------5--------
------------0------------4------5---------4--------
------------1------------4------5---------4--------
------------0------------3------0---------3--------
------------1------------3------5---------3--------
----50500101110100505----3------0---------3--------
------------1-------------------0------------------
------------1-------------------1------------------
------------2-------------------1------------------
------------1--------550500101122101005055---------
------------2-------------------2------------------
------------2-------------------2------------------
---------------------------------------------------
---------------------------------------------------
