---------------------------------------------------
---------------------------------------------------
-----222100000--222100000--44444333--44444333------
-----2-------0--2-------0--4----433--4----433------
-----2----------2---------------443-------443------
-----1----------1--------------5--4---------4------
-----0----------0-------------5---4---------4------
-----0----------0------------5----4---------4------
-----0----------0-----------5-----4---------4------
-----00---------00---------5-----44--------44------
--------------------------5------------------------
-------------------------5-------------------------
-----44---------44------5--------00--------00------
-----4----------4------5----------0---------0------
-----4----------4-----5-----------0---------0------
-----4----------4----5------------0---------0------
-----4----------4---5-------------0---------0------
-----4----------4--5--------------1---------1------
-----344--------344---------------2---------2------
-----334-----4--334-----4--0------2--0------2------
-----333444444--333444444--00001222--00001222------
---------------------------------------------------
---------------------------------------------------
