---------------------------------------------------
---------------------------------------------------
---------------------------------------------------
2222110055-0-1-2-2-1-0-5-5-5-0-1-2-2-1-0-5500112222
---------5-------------------------------5---------
---------5-------------------------------5---------
---------5-------------------------------5---------
---------5500112222110-------0112222110055---------
---------------------0-------0---------------------
---------------------0-------0---------------------
---------------------0-------0---------------------
---------------------0-------0---------------------
---------------------0-------0---------------------
---------------------0-------0---------------------
---------5-----------0-------0-----------5---------
---------0-----------0-------0-----------0---------
---------0-----------0-------0-----------0---------
---------1-----------0-------0-----------1---------
---------1-----------0-------0-----------1---------
---------2-----------0-5-5-5-0-----------2---------
---------2-------------------------------2---------
---------2-------------------------------2---------
---------2-------------------------------2---------
