---------------------------------------------------
---------------------------------------------------
---2105012------------------------------2105012----
-----------21055012------------21055012------------
---------------------455--554----------------------
---------------------455--554----------------------
--------------10551------------15501---------------
-----------10000001------------10000001------------
---------1001------------------------1001----------
-------100501------------------------105001--------
------0055501------------------------1055500-------
---------------------------------------------------
------0055501------------------------1055500-------
-------100501------------------------105001--------
---------1001------------------------1001----------
-----------10000001------------10000001------------
--------------10551------------15501---------------
---------------------455--554----------------------
---------------------455--554----------------------
-----------21055012------------21055012------------
---2105012------------------------------2105012----
---------------------------------------------------
---------------------------------------------------
