---------------------------------------------------
---------------------------------------------------
------55550500010111212-----21211101000505555------
----------------------2-----2----------------------
----------------------2-----2----------------------
------55550500010111212-----21211101000505555------
------5-------------------------------------5------
------5-------------------------------------5------
------55550500010111212-----21211101000505555------
----------------------2-----2----------------------
----------------------2-----2----------------------
------55550500010111212-----21211101000505555------
------5-------------------------------------5------
------5-------------------------------------5------
------55550500010111212-----21211101000505555------
----------------------2-----2----------------------
----------------------2-----2----------------------
------55550500010111212-----21211101000505555------
------5-------------------------------------5------
------5-------------------------------------5------
------555505000101112112222211211101000505555------
---------------------------------------------------
---------------------------------------------------
