---------------------------------------------------
---------------------------------------------------
---------------------------------------------------
---54----------5------444--------4-----------------
-------------------444444444-----------------------
----------------444444444444444--------------------
----------5--444444444444444444443-------------3---
-------------555444444444444444-------54------353--
-------------555555444444444-----3-------------3---
-------------555555555444--------3-----------------
-------------55555555555---------3-----------------
-------------55555555555---------3--5--------------
-------------55555555555---------3-----------------
-------------55555555555---------3-----------------
-------------55555555555---------3-----------------
-------4------4555555555-------33------------------
----------------45555555-----33--------------------
------------------455555---33----------------------
---------------5----4555-33------------------------
---3------------------453----------4--------54-----
--353----------------------------------------------
---3-----------------------------------------------
---------------------------------------------------
