---------------------------------------------------
---------------------------------------------------
---------------------------------------------------
---------------------------------------------------
---------------------------------------------------
---------------------------------------------------
-------111111111111---00000000-----111---111-------
-----------------111--------000----------111-------
-----------------111--------000----------111-------
-------111--111--111--00000000-----111111111-------
-------111--111--111--000---00-----111---111-------
-------111--111--111--000---000----111---111-------
-------111--111--111--000---000----111---111-------
-------111--111--111--000---000----111---111-------
-------111--111--111--000---000-55-111---111-------
-------111--111--111--000---000-55-111---111-------
---------------------------------------------------
---------------------------------------------------
---------------------------------------------------
---222212212111101101005555500101101111212212222---
---------------------------------------------------
---------------------------------------------------
---------------------------------------------------
