---------------------------------------------------
---------------------------------------------------
-------------------001-122211-100055---------------
----------------55-------------------000-----------
---------------5------------------------11---------
-------------0-----------00011-22---------1--------
------------0---------55----------1--------2-------
---2-----------------5-------------1---------------
---2-------1--------0-----5-0------1--------2------
---2-------1-------------5---0---------------1-----
--------------------0--------0------0--------1-----
----1------2---------1--------------0--------------
----1------2----------1-22211----------------0-----
----1-------2----------------------5---------0-----
----------------------------------5---------0------
-----0--------110---------------00-----------------
------0----------005-500-111-220-----------5-------
-------5----------------------------------0--------
---------0-------------------------------0---------
----------00-------------------------111-----------
-------------11222-11000-55500-111-22--------------
---------------------------------------------------
---------------------------------------------------
