---------------------------------------------------
---------------------------------------------------
---------------------------------------------------
---------------------------------------------------
-------------------555-----------------------------
----333------------555---555-----------------------
----333------------------555-----------------------
--3333333-4444444--555-5555555--444444--3333333----
----333---444--444-555---555--------444------333---
----333---444--444-555---555--------444------333---
----333---444------555---555---444--444-333--333---
----333---444------555---555---444--444-333--333---
----333---444------555---555---444--444-333--333---
----333---444------555---555---444--444-333--333---
----33333-444------555---55555-444--444-333--333---
-----3333-444------555----5555--444444--333--333---
---------------------------------------------------
---------------------------------------------------
---------------------------------------------------
---222212212111101101005555500101101111212212222---
---------------------------------------------------
---------------------------------------------------
---------------------------------------------------
