-----4444444----------------4444444----------------
----------------0-1-555----------------0-2-0-5-----
-----5-4-5-4------1---------3-5-5-5--------0-------
-------4--------2-1-0-5-------5--------111-0-1-----
-----5-4-3-5----------------5-555-4----------------
----------------1-0-222----------------5-0-1-0-----
-----5-5-5-5------0---------5-3-5-5------0---------
----------------2-0-1-0---------5------2-0-222-----
-----444-5-5----------------3-4-5-3----2-----------
---------5------111-0-1----------------2-5-1-0-----
-----5-5-5-4--------0-------4-555-4----------------
-------5--------0-2-0-5-----4----------1-000-1-----
-----5-5-555----------------4-4-5-5----------------
----------------5-0-111-------4--------0-5-1-2-----
-----4-5-4-5----------------5-4-3-5----------------
-------5--------1-5-0-2---------3------1-0-555-----
-----3-5-5-5------5---------4-5-333----------------
----------------0-5-1-0----------------5-111-0-----
-----444-5-4--------1-------5-444-5------1---------
----------------5-2-1-5----------------2-1-2-1-----
-----5-3-5-5----------------555-3-5----------------
----------------000-2-1----------------000-1-5-----
-----4444444----------------4444444----------------
