---------------------------------------------------
--3333333-4444444--555-5555555--444444--33---333---
----333---444--444-555---555---444--444-333--333---
----333---444--444-555---555---444--444-3333-333---
----333---4444444--555---555---444--444-33333333---
----333---444--444-555---555---444--444-333-3333---
----333---444--444-555---555---444--444-333--333---
----333---444--444-555---555---444--444-333--333---
----333---444--444-555---555---444--444-333--333---
----333---444--444-555---555----444444--333--333---
---------------------------------------------------
---------------------------------------------------
---2222222--111--111-000------11111111--222222-----
---222--222-111--111-000------111--111-222--222----
---222--222-111--111-000------111------222---------
---2222222--111--111-000------11111-----222222-----
---222--222-111--111-000------111-----------222----
---222--222-111--111-000------111------222--222----
---222--222-111--111-000------111------222--222----
---222--222-111--111-000--000-111--111-222--222----
---222--222--111111--00000000-11111111--222222-----
---------------------------------------------------
---------------------------------------------------
