---------------------------------------------------
-5555555555555555-555555----555555-555555555555555-
------555555------555555----555555-555555---555555-
------000000------000000----000000-000000----------
------111111------1111111111111111-111111111111----
------222222------222222----222222-222222----------
------555555------555555----555555-555555----------
------555555------555555----555555-555555---555555-
------000000------000000----000000-000000---000000-
------111111------111111----111111-111111---111111-
------222222------222222----222222-222222222222222-
---------------------------------------------------
-5555555555555555-555555----555555-55555555555555--
-555555---5555555-5555555---555555-555555---555555-
-000000-----------00000000--000000-000000---000000-
-111111111111-----111111111-111111-111111---111111-
-222222-----------2222222222222222-222222---222222-
-555555-----------5555555555555555-555555---555555-
-555555---5555555-555555-555555555-555555---555555-
-000000---0000000-000000--00000000-000000---000000-
-111111---1111111-111111---1111111-111111---111111-
-2222222222222222-222222----222222-22222222222222--
---------------------------------------------------
