-----------4---------------------------------------
-----------4---------------------------------------
-----------5---------------------------------------
-----------5---------------------------------------
-----------3---------------------------------------
-----------5---------------------------------------
-----------3---------------------------------------
-----------3-------------33333335355355555454454444
---------------------------------------------------
---------------------------------------------------
---------------------------------------------------
---------------------------------------------------
---------------------------------------------------
---------------------------------------------------
---------------------------------------------------
44445445455555355353333333-------------3-----------
---------------------------------------3-----------
---------------------------------------5-----------
---------------------------------------3-----------
---------------------------------------5-----------
---------------------------------------5-----------
---------------------------------------4-----------
---------------------------------------4-----------
