-----------3---------------------------------------
-----------3---------------------------------------
-----------4---------------------------------------
-----------4---------------------------------------
-----------5---------------------------------------
-----------4---------------------------------------
-----------5---------------------------------------
-----------5-------------55555554544544444343343333
---------------------------------------------------
---------------------------------------------------
---------------------------------------------------
---------------------------------------------------
---------------------------------------------------
---------------------------------------------------
---------------------------------------------------
33334334344444544545555555-------------5-----------
---------------------------------------5-----------
---------------------------------------4-----------
---------------------------------------5-----------
---------------------------------------4-----------
---------------------------------------4-----------
---------------------------------------3-----------
---------------------------------------3-----------
