---------------------------------------------------
---------------------------------------------------
---------------------------------------------------
--------33333333333335-------33333333333334--------
--------33535353535354-------35353535353535--------
--------35454545454544-------3-5-5-5-5-5354--------
--------335-----------------------------335--------
--------354-----------------------------354--------
--------335-----------------------------335--------
--------354-----------------------------354--------
--------335-----------------------------335--------
--------354-------010121222121010-------354--------
--------335-----------------------------335--------
--------354-----------------------------354--------
--------335-----------------------------335--------
--------354-----------------------------354--------
--------335-----------------------------335--------
--------35433333333335-------33333333333354-------
--------53535353535354-------35353535353535-------
--------45454545454544-------34545454545454--------
---------------------------------------------------
---------------------------------------------------
---------------------------------------------------
