---------------------------------------------------
---------------------------------------------------
---------------------------------------------------
--------55555555555554-------55555555555553--------
--------55454545454543-------54545454545454--------
--------54343434343433-------53434343434543--------
--------554-----------------------------554--------
--------543-----------------------------543--------
--------554-----------------------------554--------
--------543-----------------------------543--------
--------554-----------------------------554--------
--------543-------212101000101212-------543--------
--------554-----------------------------554--------
--------543-----------------------------543--------
--------554-----------------------------554--------
--------543-----------------------------543--------
--------554-----------------------------554--------
--------54355555555554-------55555555555543--------
--------45454545454543-------54545454545454--------
--------34343434343433-------53434343434343--------
---------------------------------------------------
---------------------------------------------------
---------------------------------------------------
