---------------------------------------------------
---------------------------------------------------
---------------------------------------------------
---------------------------------------------------
---------------------------------------------------
------------3------------222212212111010000--------
------------4------------2-------------------------
------------4------------1-------------------------
------------5------------0-------------------------
------------4------------1-------------------------
------------5------------0-------------------------
3343444554555------------0------------5554554443433
-------------------------0------------5------------
-------------------------1------------4------------
-------------------------0------------5------------
-------------------------1------------4------------
-------------------------2------------4------------
-------0000101112122122222------------3------------
---------------------------------------------------
---------------------------------------------------
---------------------------------------------------
---------------------------------------------------
---------------------------------------------------
