-----------5---------------------------------------
-----------5---------------------------------------
-----------5---------------------------------------
-----------4---------------------------------------
-----------4---------------------------------------
-----0-----45554445554445554445554445554445555-----
-----0---------------------------------------------
-----0---------------------------------------------
-----2---------------------------------------------
-----2---------------------------------------------
-----2---------------------------------------------
-----00022200022200022200000222000222000222000-----
---------------------------------------------2-----
---------------------------------------------2-----
---------------------------------------------2-----
---------------------------------------------0-----
---------------------------------------------0-----
-----55554445554445554445554445554445554-----0-----
---------------------------------------4-----------
---------------------------------------4-----------
---------------------------------------5-----------
---------------------------------------5-----------
---------------------------------------5-----------
