-------------------------3-------------------------
-------------------------4-------------------------
-------------------------3-------------------------
-------------------------4-------------------------
-------------------------4-------------------------
------------2------------5------------2------------
------------1------------4------------1------------
------------2------------5------------2------------
------------1------------5------------1------------
------------1------------5------------1------------
------------0-------------------------0------------
------2121105011212-------------2121105011212------
------------0-------------------------0------------
------------1------------5------------1------------
------------1------------5------------1------------
------------2------------5------------2------------
------------1------------4------------1------------
------------2------------5------------2------------
-------------------------4-------------------------
-------------------------4-------------------------
-------------------------3-------------------------
-------------------------4-------------------------
-------------------------3-------------------------
