---------------------------------------------------
-----------5-------------5-------------5-----------
-----------5-------------5-------------0-----------
-----------4-------------4-------------1-----------
--------5543455-------5543455-------5012105--------
-----------4-------------4-------------1-----------
-----------5-------------5-------------0-----------
-----------5-------------5-------------5-----------
------------------5-------------5------------------
------------------0-------------5------------------
------------------1-------------4------------------
---------------5012105-------5543455---------------
------------------1-------------4------------------
------------------0-------------5------------------
------------------5-------------5------------------
-----------5-------------5-------------5-----------
-----------0-------------5-------------0-----------
-----------1-------------4-------------1-----------
--------5012105-------5543455-------5012105--------
-----------1-------------4-------------1-----------
-----------0-------------5-------------0-----------
-----------5-------------5-------------5-----------
---------------------------------------------------
